0  0 0 0 0 0 0 0 0 0 0 0 0 0 0 0 0 0 0 0   0 0  0 0 0 0 0 0 0 0 0 0 0 0 0 0 0  0 0 0   0 0 0  0  0 0 0 0  0 0  0 0  0 0 0 0 0 0 0 0    0 0 0 0 0 0 0 0 0 0 0 0 0 0  0 0  0 0  0 0    0 0 0 0 0 0 0 0 0 0 0 0 0 0 0 0 0 0 0 0   0 0 0 0 0 0 0 0 0 0 0 0 0 0 0 0 0 0 0  0    0 0 0 0 0 0 0 0 0  0 0 0 0 0 0 0 0 0 0 0    0 0 0 0 0 0 0 0 0 0  0 0 0 0  0 0 0 0 0 0    0  0 0 0 0 0 0 0 0 0 0 0  0 0 0 0 0 0 0 0    0 0 0 0 3 3 3 3 3 3 3 3 3 3 3 3 3 3 3 3    3 3  3 3 3 3 3 3 3 3 3 3 3 3 3 3 3 3 3 3  3 3 3 3 3 3 3 3 3 3 3 3 3 3 3 3 3 3 3 3  3 3 3 3 3 3 3 3 3 3 3 3 3 3 3 3 3 3 3 3  3 3 3 3 3 3 3 3 3 3 3 3 3 3 3 3 3 3 3 3  3 3 3 3 3 3 3 3 3 0 0 0 0 0 0 0 0 0 0 0  0 0 0 0 0 0 0 0 0 0 0 0 0 0 0 0 0 0 0 0  0 0 0 0 0 0 0 0 0 0 0 0 0 0 0 0 0 0 0 0  0 0 0 0 0 0 0 0 0 0 0 0 0 0 0 0 0 0 0 0  0 0 0 0 0 0 0 0 0 0 0 0 0 0 0 0 0 0 0 0  0 0 0 0 0 0 0 0 0 0 0 0 0 0 0 0 0 0 0 0  
0  0 0 0 0 0 0 0 0 0 0 0 0 0 0 0 0 0 0 0   0 0  0 0 0 0 0 0 0 0 0 0 0 0 0 0 16 0 0 0   0 0 0  0  0 0 0 0  0 0  0 0  7 0 0 0 0 0 0 0    0 0 0 0 0 0 0 0 0 0 0 0 0 0  0 0  0 7  0 0    0 0 0 0 0 0 0 0 0 0 0 0 0 0 0 0 0 0 0 0   0 0 0 0 0 0 0 0 0 0 0 0 0 0 0 0 0 0 0  0    0 0 0 0 0 0 0 0 0  0 0 0 0 0 0 0 0 0 0 0    0 0 0 0 0 0 0 0 0 0  0 0 0 0  0 0 0 0 0 0    0  0 0 0 0 0 0 0 0 0 0 0  0 0 0 0 0 0 0 0    0 0 0 0 3 3 3 3 3 3 3 3 3 3 3 3 3 3 3 3    3 3  0 0 0 0 0 0 0 0 0 0 0 0 3 3 3 3 3 3  3 3 3 3 3 3 3 3 3 3 3 3 3 3 3 3 3 3 3 3  3 3 3 3 3 3 3 3 3 3 3 3 3 3 3 3 3 3 3 3  3 3 3 3 3 3 3 3 3 3 3 3 3 3 3 3 3 3 3 3  3 3 3 3 3 3 3 3 3 0 0 0 0 0 0 0 0 0 0 0  0 0 0 0 0 0 0 0 0 0 0 0 0 0 0 0 0 0 0 0  0 0 0 0 0 0 0 0 0 0 0 0 0 0 0 0 0 0 0 0  0 5 0 0 0 0 0 0 0 0 0 0 0 0 0 0 0 0 0 0  0 0 0 0 0 0 0 0 0 0 0 0 0 0 0 0 0 0 0 0  0 0 0 0 0 0 0 0 0 0 0 0 0 0 0 0 0 0 0 0 
0  0 0 0 0 0 7 0 0 0 0 0 0 0 7 0 0 0 0 0   0 0  0 0 0 0 0 3 0 0 0 0 0 0 0 0 0  0 0 0   0 0 0  0  0 0 0 0  0 0  0 0  0 0 0 0 0 0 0 0    0 0 0 0 0 0 0 0 0 0 0 0 0 0  0 0  0 0  0 0    0 0 3 3 0 0 3 4 3 3 0 0 0 0 0 0 0 0 0 0   0 0 0 0 0 0 0 0 0 0 0 0 0 0 0 0 0 0 0  0    0 0 0 0 0 0 0 0 0  0 0 0 0 0 0 0 0 0 0 0    0 0 0 0 0 0 0 0 0 0  7 0 0 0  0 0 0 0 0 0    16 0 0 0 0 0 0 0 0 0 0 0  0 0 0 0 0 0 0 0    0 0 0 0 0 3 3 3 3 3 3 3 3 3 3 3 3 3 3 3    3 3  0 0 0 0 0 0 0 0 0 0 0 0 3 3 3 3 3 3  3 3 3 3 3 3 3 3 3 3 3 3 3 3 3 3 3 3 3 3  0 0 0 0 0 0 0 0 0 0 0 0 0 0 0 0 0 0 0 0  0 0 0 0 0 0 0 0 0 0 0 0 0 0 0 0 0 0 0 0  0 0 0 0 0 0 0 0 0 0 0 0 0 0 0 0 0 0 0 0  0 0 0 0 0 0 0 0 0 0 0 0 0 0 0 0 0 0 0 0  0 0 0 0 0 0 0 0 0 0 0 0 0 0 0 0 0 0 0 0  0 0 0 0 0 0 0 0 0 0 0 0 0 0 0 0 0 0 0 0  0 0 0 0 0 0 0 0 0 0 0 0 0 0 0 0 0 0 0 0  0 0 0 0 0 0 0 0 0 0 0 0 0 0 0 0 0 0 0 0   
0  0 0 0 0 0 0 0 0 0 0 0 0 0 0 0 0 0 0 0   0 0  0 0 0 0 0 0 0 0 0 0 3 0 0 3 3  3 0 0   0 0 0  0  0 0 0 0  0 0  0 0  0 0 0 0 0 0 0 0    0 0 0 0 0 0 0 0 0 0 0 0 0 0  0 0  0 0  0 0    0 0 0 0 0 0 0 0 0 0 0 0 0 0 0 0 0 0 0 0   0 0 0 0 0 0 0 0 0 0 0 0 0 0 0 0 0 0 0  0    0 0 0 0 0 0 0 0 0  0 0 0 0 0 8 8 0 0 0 0    0 0 0 0 0 0 0 0 0 0  0 0 0 0  0 0 0 3 0 0    0  0 0 0 0 0 0 0 0 0 0 0  0 0 0 0 0 0 0 0    0 0 0 0 0 0 0 0 0 0 0 0 0 0 0 0 0 0 0 0    0 0  0 0 0 0 0 0 0 0 0 0 0 0 0 0 0 0 0 0  0 0 0 0 0 0 0 0 0 0 0 0 0 0 0 0 0 0 0 0  0 0 0 0 0 0 0 0 0 0 0 0 0 0 0 0 0 0 0 0  0 0 0 0 0 0 0 0 0 0 0 0 0 0 0 0 0 0 0 0  0 0 0 0 0 0 0 0 0 0 0 0 0 0 0 0 0 0 0 0  0 0 0 0 0 0 0 0 0 0 0 0 0 0 0 0 0 0 0 0  0 0 0 0 0 0 0 0 0 0 0 0 0 0 0 0 0 0 0 0  0 0 0 0 0 0 0 0 0 0 0 0 0 0 0 0 0 0 0 0  0 0 0 0 0 0 0 0 0 0 0 0 0 0 0 0 0 0 0 0  0 0 0 0 0 0 0 0 0 0 0 0 0 0 0 0 0 0 0 0   
0  0 0 0 0 0 4 0 0 0 0 0 0 4 0 0 0 0 0 0   0 0  0 0 0 3 0 0 0 0 0 0 0 0 0 0 0  0 0 0   0 0 0  0  0 0 0 0  0 0  0 0  0 4 0 0 0 0 0 0    0 0 0 0 0 0 0 0 0 0 0 0 0 0  0 0  0 0  0 0    0 0 0 0 0 0 0 0 0 0 0 0 0 0 8 0 0 8 0 0   0 0 0 0 0 0 0 0 0 8 8 0 0 8 0 0 0 0 12 0    0 0 0 0 0 0 0 0 0  0 0 0 0 8 8 8 8 0 0 0    0 0 0 0 0 0 0 0 0 18 0 0 0 4  0 0 0 0 0 0    0  0 0 0 0 0 0 0 0 0 0 0  0 0 0 0 0 0 0 0    0 0 0 0 3 3 3 0 0 0 0 0 0 0 0 0 0 0 0 0    0 0  0 0 0 0 0 0 0 0 0 0 0 0 0 0 0 0 0 0  0 0 0 0 0 0 0 0 0 0 0 0 0 0 0 0 0 0 0 0  0 0 0 0 3 0 0 0 0 0 3 0 0 0 0 0 0 0 0 0  0 0 0 3 3 3 3 3 3 3 3 3 3 3 3 3 3 3 3 3  3 3 3 3 3 3 3 3 3 0 0 0 0 0 0 0 0 0 0 0  0 0 0 0 0 0 0 0 0 0 0 0 0 0 0 0 0 0 0 0  0 0 0 0 0 5 0 0 0 0 0 0 5 0 0 0 0 0 5 0  0 0 0 0 0 0 0 5 0 0 0 0 0 0 0 0 0 0 0 0  0 0 0 0 0 0 0 0 0 0 0 0 0 0 0 0 0 0 0 0  0 0 0 0 0 0 0 0 0 0 0 0 0 0 0 0 0 0 0 2   
0  0 0 0 0 0 0 0 0 3 0 0 0 0 0 0 0 0 0 16  0 0  0 0 0 0 0 7 0 3 4 0 0 0 0 0 0  0 0 0   0 0 0  0  0 0 0 0  0 0  0 16 0 0 0 3 3 4 0 0   16 0 0 0 0 0 3 0 0 3 3 0 0 16 0 16 0 16 0 0    3 0 0 0 0 0 0 0 0 0 0 0 0 8 8 0 0 8 8 0   0 0 0 0 0 0 0 0 8 8 8 0 0 8 8 0 0 0 11 0    0 0 3 3 3 0 0 0 0  0 0 0 8 8 8 8 8 8 0 0    0 0 0 0 0 3 0 0 0 0  0 0 0 0  0 0 0 0 0 0    3  0 0 0 0 0 0 0 0 0 0 16 0 0 0 0 0 0 0 0    0 0 0 0 3 3 3 3 0 0 0 0 0 0 0 0 0 0 0 0    0 0  0 0 0 0 0 0 0 0 0 0 0 0 0 3 3 3 3 3  3 3 3 3 3 3 3 3 3 3 3 3 3 3 3 3 3 3 3 3  0 0 0 0 0 0 0 0 0 0 0 0 0 0 0 0 3 0 0 0  3 0 0 0 0 0 0 0 0 0 0 0 0 0 0 0 0 0 0 0  0 0 0 0 0 0 0 0 0 0 0 3 3 0 0 0 0 0 0 3  3 4 0 0 0 0 0 0 0 0 0 0 0 0 0 0 0 0 0 0  0 0 0 0 0 0 0 0 0 0 0 0 0 0 0 0 0 0 0 0  0 0 0 0 0 0 0 0 0 0 0 0 0 0 0 0 0 0 0 0  0 0 0 0 0 0 0 0 0 0 0 0 5 5 5 0 0 0 0 0  0 0 0 0 0 0 0 0 0 0 0 0 0 0 0 0 0 0 2 2 
0 14 0 0 0 0 0 0 0 0 0 3 0 0 0 0 0 0 0 0   0 0  0 3 0 0 0 0 0 0 0 0 0 0 0 0 0  0 0 0   0 0 12 0  0 0 0 12 0 14 0 0  0 0 0 0 0 0 0 0    0 0 0 0 0 0 0 0 0 0 0 0 0 0  0 0  0 0  0 0    0 0 0 0 0 0 0 0 0 0 0 0 8 8 8 0 0 8 8 8   0 0 0 0 0 0 0 8 8 8 8 0 0 8 8 8 0 0 11 0    0 0 0 0 0 0 0 0 13 0 0 8 8 8 8 8 8 8 8 0    0 0 0 0 0 0 0 0 0 0  0 0 0 0  0 3 0 0 0 0    0  0 0 3 0 0 0 0 0 0 0 0  0 0 0 0 0 0 0 0    0 0 3 0 3 3 3 3 3 0 0 0 0 0 0 0 0 0 0 0    0 0  0 0 0 0 0 3 3 0 0 0 0 0 3 3 3 3 3 3  3 3 3 3 3 3 3 3 3 3 3 3 3 3 3 3 3 3 3 3  0 0 0 0 0 0 0 3 0 0 0 0 0 0 0 0 0 0 0 0  3 0 0 0 0 0 0 0 0 0 0 0 0 0 0 0 0 0 0 0  0 0 0 0 0 0 0 0 0 0 0 3 3 0 0 3 3 0 0 0  0 0 0 0 3 3 0 0 3 3 3 3 3 3 0 0 0 0 3 0  3 3 0 0 0 0 0 0 0 0 0 0 0 0 0 0 0 0 0 0  0 0 0 0 0 0 0 0 0 0 0 0 0 0 0 0 0 0 0 0  0 0 0 0 0 0 0 0 0 0 0 0 0 0 0 0 0 0 0 0  0 0 0 0 0 0 0 0 0 0 0 0 0 0 0 0 0 0 2 2 
0  0 0 0 0 0 0 0 0 0 0 0 0 3 0 0 0 0 0 0   0 0  0 0 0 0 0 0 0 0 0 0 0 0 0 0 0  0 0 0   0 0 11 0  0 7 0 11 0 0  0 0  0 0 0 0 0 0 0 0    0 0 0 0 0 0 0 0 0 0 0 0 0 0  0 0  0 0  0 0    0 0 0 0 0 0 0 0 0 0 0 8 8 8 8 0 0 8 8 8   8 0 0 0 0 0 8 8 8 8 8 0 0 8 8 8 8 0 11 0    0 0 0 0 0 0 0 0 0  0 8 8 8 8 8 8 8 8 8 8    0 0 0 0 0 0 0 0 0 1  0 3 0 0  0 0 0 0 0 0    0  0 0 0 0 0 0 0 0 0 0 0  0 0 0 0 0 0 0 0    0 0 0 0 3 3 3 3 3 3 3 3 3 3 3 3 3 0 3 3    3 3  3 3 3 0 0 3 3 0 0 0 0 0 3 3 3 3 3 3  3 3 3 3 3 3 3 3 3 3 3 3 3 3 3 3 3 3 3 3  0 0 3 0 0 0 0 0 0 0 0 0 0 0 0 0 0 0 0 0  3 3 3 3 3 3 3 3 3 3 3 3 3 3 3 3 3 3 3 3  3 3 3 3 3 3 3 3 3 3 4 3 3 0 0 0 0 0 0 0  0 0 0 0 0 0 0 0 3 3 3 3 3 3 0 0 0 0 3 0  3 3 0 0 0 0 0 0 0 5 0 0 0 0 0 5 0 0 0 0  0 0 0 0 5 0 0 0 0 0 2 0 0 2 2 2 2 2 2 2  2 0 0 2 2 2 2 2 2 2 2 2 0 0 0 0 0 0 0 5  5 5 0 0 2 2 2 2 2 2 2 2 2 2 2 2 2 2 2 2 
2  2 2 2 1 2 2 2 2 2 0 0 0 0 0 2 1 2 2 2   2 2  0 0 0 2 0 1 0 0 0 2 2 2 0 0 0  0 0 0   2 2 2  2  2 2 2 2  2 2  2 2  2 0 0 0 0 0 2 2    2 0 0 2 2 2 2 2 2 2 2 2 2 2  2 2  2 2  2 2    2 2 2 2 2 2 2 1 2 2 2 2 2 2 2 1 0 2 2 2   2 2 2 2 2 2 2 2 2 2 2 0 2 2 2 2 2 0 2  2    2 2 2 2 2 2 1 2 2  2 2 2 2 2 2 2 2 2 2 2    2 2 2 0 0 0 0 2 0 0  0 0 0 18 0 0 0 3 0 0    0  0 0 0 0 0 1 2 2 2 2 2  2 2 2 2 0 0 0 0    0 2 2 2 3 3 3 3 3 3 3 3 3 3 3 3 3 0 3 3    3 3  3 3 3 0 0 3 3 0 0 0 0 3 3 3 3 3 3 3  3 3 3 3 3 3 3 3 3 3 3 3 3 3 3 3 3 3 3 3  0 0 0 0 0 3 0 0 0 0 3 0 0 3 0 0 0 0 0 0  3 3 3 3 3 3 3 3 3 3 3 3 3 3 3 3 3 3 3 3  3 3 3 3 3 3 3 3 3 3 4 3 3 0 0 0 0 0 0 3  0 0 3 0 0 0 0 0 3 3 3 3 3 3 3 3 3 3 3 0  3 3 0 0 0 0 0 0 0 0 0 0 0 0 0 0 0 0 0 0  0 0 0 0 0 0 0 0 0 0 2 0 0 2 2 2 2 2 2 2  2 0 0 2 2 2 2 2 2 2 2 2 0 0 0 0 0 0 0 0  0 0 0 0 2 2 2 2 2 2 2 2 2 2 2 2 2 2 2 2 
2  2 2 2 1 2 2 2 2 2 0 0 0 0 0 2 1 2 2 2   2 2  0 0 0 0 0 0 0 0 0 0 0 0 0 0 0  2 0 0   2 2 2  2  2 2 2 2  2 2  2 2  2 0 0 0 0 0 0 0    0 0 0 2 2 2 2 2 2 2 2 2 2 2  2 2  2 2  2 2    2 2 2 2 2 2 2 1 2 2 2 2 2 2 2 1 0 2 2 2   2 2 2 2 2 2 2 2 2 2 2 0 2 2 2 2 2 0 2  2    2 2 2 2 2 2 1 2 2  2 2 2 2 2 2 2 2 2 2 2    2 2 2 0 0 0 0 0 0 0  0 0 0 0  0 0 0 0 0 0    0  0 0 0 0 0 1 2 2 2 2 2  2 2 2 2 0 0 0 0    0 2 2 2 3 3 3 3 3 3 3 3 3 3 3 3 3 0 3 3    3 3  3 3 3 0 0 3 3 0 0 0 0 3 3 3 3 3 3 3  3 3 3 3 3 3 3 3 3 3 3 3 3 3 3 3 3 3 3 3  0 0 0 0 0 0 0 0 0 0 0 0 0 0 0 0 0 0 0 0  3 3 3 3 3 3 3 3 3 3 3 3 3 3 3 3 3 3 3 3  3 3 3 3 3 3 3 3 3 3 4 3 3 0 0 0 0 0 0 0  0 0 0 0 0 0 0 0 3 3 3 3 3 3 3 3 3 3 3 0  3 3 0 0 0 0 0 0 0 0 0 0 0 0 0 0 0 0 0 0  0 0 0 0 0 0 0 0 0 0 2 0 0 2 2 2 2 2 2 2  2 0 0 2 2 2 2 2 2 2 2 2 0 0 0 0 0 0 0 0  0 0 0 0 2 2 2 2 2 2 2 2 2 2 2 2 2 2 2 2